wwwwwwwwwwwww
wA.......b..w
w..b........w
w...b...b.tww
www.w2..wwwww
w.b..wwwwwwww
w.......w...w
w...2w....w.w
wwwwwwwwwwwwT