wwwwwwwwwwwww
wA.......b..w
w..b........w
w...b...b.tww
www.w2..wwwww
w.......b...w
w.3.........w
w.....3.....w
wwwwwwwwwwwwT